xxxxxxxxxxxsxxxxxxxxx
x.......x.........x.x
x.x.x.xxx.xxxxxxx.x.x
x.x.x.x.x...x...x.x.x
x.x.xxx.xxx.x.xxx.x.x
x.x...x...x.x...x.x.x
x.xxx.xxx.x.x.x.x.x.x
x...x...x.x.x.x.x.x.x
xxx.x.x.x.x.xxx.x.x.x
x...x.x.x...x...x.x.x
x.xxx.xxxxxxx.xxx.x.x
x...x.......x...x...x
xxxxxxxxx.x.xxx.xxx.x
x...x.....x.....x...x
x.x.x.xxxxx.xxxxx.xxx
x.x...x.x...x...x...x
x.xxxxx.x.xxx.x.xxx.x
x.....x.....x.x...x.x
x.xxx.xxxxxxx.xxx.x.x
x...x...........x...x
xxxxxxxxxxxexxxxxxxxx
