xxxxxxxxxxxsxxxxxxxxx
x...x...........x...x
x.x.x.x.xxxxxxx.x.x.x
x.x.x.x.x...x...x.x.x
x.x.xxx.x.x.x.xxx.x.x
x.x...x...x.x.x...x.x
x.xxxxxxxxx.x.x.xxx.x
x.x.........x.x...x.x
x.x.xxxxxxxxx.xxx.x.x
x.x.....x.........x.x
x.x.xxx.x.xxxxxxxxx.x
x.x.x...x.x.......x.x
x.x.x.xxxxx.xxxxx.x.x
x.x.x.........x...x.x
x.x.xxxxxxxxxxx.xxx.x
x.x.....x.......x.x.x
x.xxxxxxx.xxxxxxx.x.x
x...x...x.x.x.....x.x
xxx.x.x.x.x.x.xxx.x.x
x.....x...x.....x...x
xxxxxxxxxxxexxxxxxxxx
