xsxxxxxxxxxxxxxxxxxxx
x.x.....x...........x
x.xxx.xxx.xxxxxxxxx.x
x...x.....x.x.....x.x
xxx.xxx.xxx.x.xxx.x.x
x.x...x.x...x...x.x.x
x.xxx.x.x.xxxxx.x.x.x
x.x...x...x...x.x.x.x
x.x.xxxxxxx.x.x.x.x.x
x.x.x.....x.x...x...x
x.x.x.xxx.x.xxxxxxx.x
x...x...x.x.......x.x
x.xxxxx.x.xxx.xxx.x.x
x...x...x...x.x...x.x
xxx.x.xxxxx.x.x.xxxxx
x.x.x...x...x.x.....x
x.x.xxx.x.xxx.xxxxx.x
x.x...x.x.x.......x.x
x.xxx.x.x.xxxxxxxxx.x
x.......x...........x
xxxxxxxxxxxxxxxxxxxex
