xsxxxxxxxxxxxxxxxxxxxxxxxxxxxxxxxxxxxxxxx
x.x...........x.....x.......x...x...x...x
x.xxxxxxx.xxx.xxx.xxx.x.xxx.x.x.x.x.x.x.x
x...x.....x.....x.....x...x.x.x...x...x.x
xxx.x.xxxxxxxxx.x.xxxxxxx.x.xxxxxxxxxxx.x
x...x.x.......x.x...x.x...x.....x...x...x
x.xxx.x.xxxxx.x.xxx.x.x.xxxxxxx.x.x.x.x.x
x...x.x.x.....x.x.x.x.x.......x...x.x.x.x
xxx.x.x.x.xxxxx.x.x.x.xxxxxxx.xxxxx.x.xxx
x...x...x.x...x.x.....x.......x...x.x...x
x.xxxxxxx.x.xxx.x.xxxxx.xxxxxxxxx.x.xxx.x
x.......x.x.x...x.x...x.....x.....x.....x
xxxxxxx.x.x.x.xxxxx.x.xxxxx.x.xxxxxxxxx.x
x...x...x.x...x...x.x.x...x.x...x...x...x
x.x.x.xxx.x.xxx.x.x.x.x.x.x.x.x.x.x.x.xxx
x.x.x.....x...x.x.x.x...x...x.x.x.x.x...x
x.x.xxxxxxxxx.x.x.x.xxxxxxxxx.x.x.x.xxx.x
x.x.x.......x...x.x.x...x.....x.x.x.....x
x.xxx.x.xxx.xxxxx.x.xxx.x.xxxxx.x.xxxxxxx
x...x.x.x...x.....x.x...x.....x...x.....x
x.x.x.x.xxxxx.xxxxx.x.xxxxxxx.xxxxx.x.xxx
x.x.x.x.....x.......x.x...x...x...x.x...x
x.x.x.xxxxx.xxxxxxxxx.x.x.x.xxxxx.x.xxx.x
x.x.x.x.....x...x.....x.x...x...x...x...x
x.x.x.x.xxx.x.x.xxx.x.x.xxxxx.x.xxxxx.x.x
x.x.x.x...x...x.x...x.x.x.....x.x.....x.x
x.x.x.xxx.xxxxx.x.xxx.x.x.xxx.x.x.xxxxx.x
x.x...x.x.....x...x...x.x...x.x...x...x.x
x.xxxxx.xxxxx.xxx.xxxxx.xxx.x.x.xxxxx.x.x
x.x.....x...x.x.x.x...x.x.x.x.x.x...x...x
x.xxx.x.x.x.x.x.x.x.x.x.x.x.x.xxx.x.x.xxx
x.x...x.x.x.x.x...x.x.x.x.x.x.....x.x.x.x
x.x.xxxxx.x.x.xxxxx.x.x.x.x.xxxxxxx.x.x.x
x.x.....x.x...x.....x...x...x...x...x...x
x.xxxxx.x.xxxxx.xxxxxxxxxxxxx.x.x.xxxxx.x
x.x.....x.x.....x.....x.....x.x...x...x.x
x.x.xxxxx.x.xxxxx.xxx.x.xxx.x.xxxxx.x.x.x
x.x.....x...x.....x.x.x.x...x.x.....x...x
x.xxxxx.xxxxxxx.xxx.x.x.x.xxx.x.xxxxxxxxx
x...............x.......x.....x.........x
xxxxxxxxxxxxxxxxxxxxxxxxxxxxxxxxxxxxxxxex
