xxxxxxxxxxxxxxxsxxxxxxxxxxxxxxx
x...............x.............x
xxx.xxxxxxxxxxx.x.xxxxxxxxxxx.x
x...x...x.....x.x.x...x...x...x
x.xxx.xxx.xxx.x.x.xxx.x.x.x.x.x
x.....x...x.x...x.....x.x...x.x
xxxxxxx.xxx.xxxxxxxxx.x.xxxxx.x
x.....x.x...........x.x.x.....x
x.xxxxx.xxx.xxxxx.x.xxx.x.xxxxx
x.....x...x.....x.x.....x.x...x
x.xxx.xxx.xxxxxxx.xxxxxxx.xxx.x
x...x.x...x...x...x...x...x...x
xxxxx.x.xxx.x.x.xxx.x.x.xxx.x.x
x.....x...x.x...x...x.x.x...x.x
x.xxx.xxx.x.xxxxx.x.x.x.xxx.x.x
x.x.x...x...x...x.x.x.x.x...x.x
x.x.x.xxxxxxx.x.x.x.xxx.x.xxx.x
x.x...x.....x.x.x.x...x.x.x...x
x.xxxxx.x.xxx.x.x.xxx.x.x.xxxxx
x.......x.....x...x.x.x.x.....x
x.xxxxxxxxxxxxxxxxx.x.x.xxxxx.x
x.....x...x.........x.x...x...x
xxxxx.x.x.x.xxx.xxxxx.xxx.x.xxx
x...x...x...x...x...x.x...x...x
x.x.xxxxx.xxxxxxx.x.x.x.xxxxx.x
x.x...x...x.......x...x.x.....x
x.xxx.x.xxx.xxxxx.xxxxx.x.xxxxx
x...x.x.x.x.....x.x.....x.....x
xxx.x.x.x.xxxxx.xxx.xxxxxxxxx.x
x...x.........x...............x
xxxxxxxxxxxxxxxexxxxxxxxxxxxxxx
