xxxxxxxxxxxsxxxxxxxxx
x.x.....x.....x.....x
x.x.xxx.x.x.xxx.xxx.x
x.x...x...x.....x...x
x.xxx.xxxxxxx.xxx.x.x
x...x...x...x...x.x.x
x.xxxxx.x.xxxxx.x.xxx
x.....x.x...x...x...x
xxx.x.x.xxx.xxxxxxx.x
x...x.x.x.x.x.......x
x.xxxxx.x.x.x.xxxxxxx
x.x.....x.x...x.....x
x.x.xxxxx.xxxxx.xxx.x
x.x.x...........x...x
x.x.xxxxx.xxxxxxx.xxx
x.x.......x.......x.x
x.xxxxxxxxx.xxxxxxx.x
x...x.....x.x.......x
x.xxx.xxx.x.xxx.xxx.x
x.......x.......x...x
xxxxxxxxxxxexxxxxxxxx
