xxxxxxxxxxxsxxxxxxxxx
x.............x.....x
x.xxxxxxxxx.xxx.x.x.x
x.......x.x.....x.x.x
xxxxxxx.x.xxxxxxx.x.x
x...x...x...x.....x.x
x.x.xxx.x.x.x.xxxxxxx
x.x...x.x.x.x.......x
x.xxx.x.xxx.xxxxxxx.x
x.x.x.x...x...x.....x
xxx.x.xxx.xxx.x.xxxxx
x...x...x.....x.....x
x.x.xxx.xxxxx.xxxxx.x
x.x...x...x.......x.x
x.xxx.xxx.x.xxxxxxx.x
x.x.x...x.x.x.....x.x
x.x.x.xxx.x.x.xxx.x.x
x.x...x...x.x.x.x.x.x
x.xxxxx.xxxxx.x.x.x.x
x.............x.....x
xxxxxxxxxxxexxxxxxxxx
