xxxxxxxxxxxxxxxxxxxxx
xs..................x
x...................x
x...................x
x...................x
x...........x.x.x.x.x
x...........x.x.x.x.x
x...........x.x.x.x.x
x...........x.x.x.x.x
xxxxxxxxxxxxxxxxx.x.x
x.................xxx
x.................x.x
x.xxxxxxxxxxxxxxxxx.x
x...................x
x...................x
x...................x
x...................x
x...................x
x...................x
x...................x
xxxxxxxxxxxexxxxxxxxx
