xxxxxxxxxxxsxxxxxxxxx
x.......x.....x.....x
xxx.xxx.xxx.x.x.xxx.x
x...x.......x.x.x.x.x
x.xxxxxxx.xxxxxxx.x.x
x.......x.x.........x
x.xxxxx.xxx.xxxxxxxxx
x...x.x.....x.......x
xxx.x.xxxxxxx.x.xxx.x
x.x...x.....x.x.x...x
x.xxx.xxx.x.xxx.xxx.x
x...x.....x...x...x.x
xxx.xxxxxxxxx.x.x.x.x
x...x.....x...x.x.x.x
x.x.x.xxx.x.xxxxx.x.x
x.x.x.x...x...x...x.x
x.xxx.x.xxxxx.x.xxx.x
x.....x.......x.x...x
x.xxxxxxxxxxxxx.x.xxx
x...............x...x
xxxxxxxxxxxexxxxxxxxx
